20 20 -1
####################
#$  *  *    *  *  F#
# ##### *  * ##### #
# #   #  %   #   # #
#*# X #      # 3 #*#
# #   # *  * #   # #
# ##D##      ##D## #
#*        *       *#
# *   * * ^* *   * #
#  F^           ^  #
#    *    F*       #
# *   * *  * *   * #
#* 0              *#
# ##D##   *  ##D## #
# #   # *  * #   # #
#*# * #  S   # * #*#
# #   #   X  #   #3#
# ##### *  * ##### #
#X  *  F*   *  *   #
####################