20 20 -1
######### ##########
#$  *  *    *  *  F#
#       *  * ##### #
#        %   #   # #
#*  X     ^  # * #*#
#     # *  * #   # #
#  3         ##D## #
#*        *       *#
# *   * *  * *   * #
#  F^           ^  #
#    *    F*       #
# *   * *  * *   * #
#* 0     ^        *#
#         *        #
#       *  *       #
#*  *3   S     *  *#
#         X       3#
#       *  *       #
#X  *  F*   *  *   #
######### ##########
