20 20 59
####################
#$  *  *  + *  *  F#
# ##### *  * ##### #
# #   #  %   #*X*# #
#*# F #########D##*#
# #     +        #^#
# ##D############# #
#*        *       *#
# *   * *  * *   * #
#  F^           ^  #
#    *   ^   *     #
# *   * *  * * * * #
#* 0              *#
# #############D## #
# #      S  +    # #
#*###D######## F #*#
# # * #   X  #   #3#
# ##### *  * ##### #
# + *  F*   *  *   #
####################